1111111
1PEC111
11C1111
1111111
