1111111
1E10001
1C10001
10P0001
10C1111
1111111
